WWWWWWWWWWWWWWWWWWWWWWWWWWWWWWWWWWW
W....................X............W
WFFFFFFFFLFFFFFFFF...L............W
W........LCCCCCCCCCCCL............W
W........L...........L..........E.W
W........L.....FFL...FFFFFFFFFFLFFW
W........L.....FFL.............L..W
W.E......L.....FFL.............L..W
WFFFLFFFFF.....FFFFFFFFFLFFFFFFFFFW
W...L...................L.........W
W...L...................L.........W
WFFFFFFFFFFLFFF........FL.........W
W..........L............L.........W
W..........L............L.........W
W......FFFFFFF..........FFFFFFFFF.W
W...........B..HR.................W
WFFFFFFFFFFFFFFFFFFFFFFFFFFFFFFFFFW
WWWWWWWWWWWWWWWWWWWWWWWWWWWWWWWWWWW
