WWWWWWWWWWWWWWWWWWWWWWWWWWWWWWWWWWW
W....................X............W
W....................L............W
W....................L............W
W....................L............W
W....................FFFFFFFFFFLFFW
W..............................L..W
W............E...R...E.........L..W
WFFFLFFFFFFFFFFFFFFFFFFFFFFFFFFFFFW
W...L.............................W
W...L.............................W
W...L.............................W
W...L.............................W
W...L.............................W
W...L.............................W
W...L.......B.....................W
WFFFFFFFFFFFFFFFFFFFFFFFFFFFFFFFFFW
WWWWWWWWWWWWWWWWWWWWWWWWWWWWWWWWWWW
