WWWWWWWWWWWWWWWWWWWWWWWWWWWWWWWWWWW
W.....B..............X............W
WFFFFFFFFLFFFFFFFF...L............W
W........LCCCCCCCCCCCL............W
W........L...........L......B...E.W
W........L.....FFL...FFFFFFFFFFLFFW
W........L.....FFL.............L..W
W.E......L.....FFL.........B...L..W
WFFFLFFFFF.....FFFFFFFFFLFFFFFFFFFW
W...L...................L.........W
W...L...........E.......L.........W
WFFFFFFFFFFLFFFFFFFFFFFFL.........W
W..........L............L.........W
W........B.L............L.....B...W
W......FFFFFFF..........FFFFFFFFF.W
W...E...............RL............W
WFFFFFFFFFFFFFFFFFFFFFFFFFFFFFFFFFW
WWWWWWWWWWWWWWWWWWWWWWWWWWWWWWWWWWW
