WWWWWWWWWWWWWWWWWWWWWWWWWWWWWWWWWWW
W.....B......R.......X............W
WFFFFFFFFLFFFFFFFF...L............W
W........LCCCCCCCCCCCL............W
W........L...........L......B.....W
W........L.....FFL...FFFFFFFFFFLFFW
W........L.....FFL.............L..W
W........L.....FFL.........B...L..W
WFFFLFFFFF.....FFFFFFFFFLFFFFFFFFFW
W...L...................L.........W
W...L...................L.........W
WFFFFFFFFFFLFFFFFFFFFFFFL.........W
W..........LCCCCCCCCCCCCL.........W
W........B.L............L.....B...W
W.....LFFFFFFF..........FFFFFFFFFLW
W.....L..............B...........LW
WFFFFFFFFFFFFFFFFFFFFFFFFFFFFFFFFFW
WWWWWWWWWWWWWWWWWWWWWWWWWWWWWWWWWWW
