WWWWWWWWWWWWWWWWWWWWWWWWWWWWWWWWWWW
W....................X............W
W.................................W
W.................................W
W.................................W
W.................................W
W.................................W
W.................................W
W.................................W
W.................................W
W.................................W
W.................................W
W.................................W
W......L..........................W
W......L..........................W
W.....RL.....................B....W
WFFFFFFFFFFFFFFFFFFFFFFFFFFFFFFFFFW
WWWWWWWWWWWWWWWWWWWWWWWWWWWWWWWWWWW
