WWWWWWWWWWWWWWWWWWWWWWWWWWWWWWW
W...B........................XW
WLFFFFFL...........B.........LW
WL.....L....LFFFFFFFFFL.B....LW
WL.B.E.L....L.........LFFFFFFLW
WLFFFFFL....L.......E.L.......W
WL.....LCCCCLCCCCCCFFFFFFFFFFLW
WL.....L....L.....L..........LW
WL.....L....L.....L..........LW
WL...E.L.B..LFFFFFL..........LW
WL..FFFFFFFFL..........LFFFLFFW
WL..FF......L..........L...L..W
WL..FF......L...CCCCCCCL...L..W
WL..FF......L..........L...L..W
WL..FFFFFLFFFFFFF......L..FFFFW
WL.......L.............L......W
WLB......L....R........L......W
WFFFFFFFFFFFFFFFFFFFFFFFFFFFFWW
WWWWWWWWWWWWWWWWWWWWWWWWWWWWWWW